1111111111111
10000000C0011
10C0011111001
10010P00C0001
1001000010001
10001111E0111
1C011E00000C1
1111111111111