111111111111111111111111111111111111111
1P0000E00000000000000000000000000000001
10000000000000000C000000000000000C00001
100000000000000000000000000000000000001
10101010101010101010101010000C000011111
100000000000000000000010111111111111001
100000000000C00000000010101111111111001
100000100000000000000010001000000001001
100000000000000000000010001000000001001
100000000000000000000010101000000001001
100000000000000000000010101000000001101
111111111111111111111111111111111111111