1111111111111111111
10000000C0000001111
1001011111000001111
10010000C0000001111
100100000000000E111
10001111101100000C1
1P011E00000C0000001
1000000000000000001
10011111111000000C1
10000000C0000000111
1001C00000000001111
1111111111111111111