11111111111
11001101001
1E101110001
10000C00C11
100C0000111
11111111111