11111111
11110100
10000101
11ECP001
11111111